aeroplane 	 ['airplane', 'plane']
bicycle 	 ['bike']
bird 	 []
boat 	 []
bottle 	 []
bus 	 ['autobus', 'motorbus', 'motorcoach']
car 	 ['motorcar']
cat 	 []
chair 	 []
cow 	 []
dining table 	 ['table']
dog 	 []
horse 	 []
motorbike 	 []
person 	 ['human', 'someone', 'somebody', 'man', 'women']
potted plant 	 []
sheep 	 []
sofa 	 ['couch']
train 	 []
tv 	 ['television', 'TV', 'monitor']	